02222222222022222222220
04000200002020000200020
02000200002020000200020
02222222222222222222220
02000202000000020200020
02222202222022220222220
00000200002020000200000
00000202222322220200000
00000202000200020200000
22222222022222022222222
00000202000000020200000
00000202222222220200000
00000202000000020200000
02222222222022222222220
02000200002020000200020
02220222222222222202220
00020202000000020202000
02222202222022220222220
02000000002020000000020
02222222222222222222220