01111111111011111111110
04000100001010000100010
01000100002010000100010
01111111111111111111110
01000101000000010100010
01111101111011110111110
00000100001010000100000
00000101111311110100000
00000101000100010100000
11111111011111011111111
00000101000000010100000
00000101211111110100000
00000101000000010100000
01111111111011111111110
01000100001010000100010
01110111111111111101110
00010101000000010101000
01111101111011110111110
01000000001010000000010
01111111111111111111110